0000000000000000000000000000000000
0000000000000000000000000000000000
00000000000000000000000000000S0000
0000000000000000000000000000010000
0000T00C00000000000000000000000000
3030303030000000000000003000000000
0000000000000000002000000000000000
0000000000000000000S00000000000000
0000000000000000000303000000000000
0000000000000000000000000000000000
0000000000000000000000000000000000
0000000000000100000303030000000000
N000Q00001000000000000000000000000
3030303000000000000000000000000000
0011111111100000000000000000000000
0030303000000000000000000000000000
0000000000000000000000000000000000