00000000000000B00000000000B0000000
0000000000000200000000000000000000
0000100001000200000000000000000000
Q0Q0000000020000000000000000000000
333000Q000000000000000000000000000
00000010B0000000000000000000000000
0000000000000000000001110000000000
0000000000000000000000000000000000
000000000000B000000000000000000000
1100000000000000000000000000000111
0000000001000000000000001000000000
0000000000000000010000000000000000
00000000000B0000000000000000000000
0000001000000010000000001000000000
0000000001000000000000000001000000
000000B00000000000000000000000Q0T0
3333333333333333333333333333333333
