0000000000000000000000000000000000
00000C0000000000000000000000000000
0000B00000000000000000000000000000
0000B00000000000000000000000000000
0000000B00000000000000000000000000
0000000B0000000B003000000Q00000T00
0000000333333333030303030303030300
00C0000000000000000000000000000000
0000000000000000000000001000000000
0000000000000000000000000000333000
3030303030000000000000C00000000000
00000000000000C00000000001Q0000000
0030303030303030303030303030000000
0000000000000000000000000000000000
000000000000000000000000000000N000
0000000000000000000000000000030000
0000000000000000000000000000000000
0000000000000000000000000000000000